25 22 22 22 22 22 22 22 22 22 22 22 22 22 22 22 22 26
19 17 14 14 14 14 14 14 14 14 14 14 14 14 14 14 18 20
19 11 10 10 10 10 10 10 10 10 10 10 10 10 10 10 13 20
19 11 10 10 10 10 10 10 10 10 10 10 10 10 10 10 13 20
19 11 10 10 10 10 10 10 10 10 10 10 10 10 10 10 13 20
19 11 10 10 10 10 10 10 10 10 10 10 10 10 10 10 13 20
19 11 10 10 10 10 10 10 10 27 10 10 10 10 10 10 13 20
19 11 10 10 10 10 10 10 10 10 10 10 10 10 10 10 13 20
19 11 10 10 10 10 10 10 10 10 10 10 10 10 10 10 13 20
19 11 10 10 10 10 10 10 10 10 10 10 10 10 10 10 13 20
19 15 12 12 12 12 12 12 12 12 12 12 12 12 12 12 16 20
23 21 21 21 21 21 21 21 21 21 21 21 21 21 21 21 21 24